###############
#...#...#....E#
#.#.#.#.#.....#
#.#.#.#.#####.#
#.#.#.#.#...#.#
#.#.#.#.#.##..#
#.#.#.#.#.#.#.#
#.#.#.#.#...#.#
#.#.#.#....#..#
#.#.#.#.##.#..#
#.#.#.#.#..#..#
#.#.#.#.#..#..#
#.#.#.#.####..#
#S#...#.......#
###############